Illumina_Single_End_Adapter_1                 	ACACTCTTTCCCTACACGACGCTGTTCCATCT
Illumina_Single_End_Adapter_2                 	CAAGCAGAAGACGGCATACGAGCTCTTCCGATCT
Illumina_Single_End_PCR_Primer_1              	AATGATACGGCGACCACCGAGATCTACACTCTTT
Illumina_Single_End_PCR_Primer_2              	CAAGCAGAAGACGGCATACGAGCTCTTCCGATC
Illumina_Single_End_Sequencing_Primer         	ACACTCTTTCCCTACACGACGCTCTTCCGATCT
Illumina_Paired_End_Adapter_1                 	ACACTCTTTCCCTACACGACGCTCTTCCGATCT
Illumina_Paired_End_Adapter_2                 	CTCGGCATTCCTGCTGAACCGCTCTTCCGATCT
Illumina_Paried_End_PCR_Primer_1              	AATGATACGGCGACCACCGAGATCTACACTCTTT
Illumina_Paired_End_PCR_Primer_2              	CAAGCAGAAGACGGCATACGAGATCGGTCTCGGC
Illumina_Paried_End_Sequencing_Primer_1       	ACACTCTTTCCCTACACGACGCTCTTCCGATCT
Illumina_Paired_End_Sequencing_Primer_2       	CGGTCTCGGCATTCCTACTGAACCGCTCTTCCGA
Illumina_DpnII_expression_Adapter_1           	ACAGGTTCAGAGTTCTACAGTCCGAC
Illumina_DpnII_expression_Adapter_2           	CAAGCAGAAGACGGCATACGA
Illumina_DpnII_expression_PCR_Primer_1        	CAAGCAGAAGACGGCATACGA
Illumina_DpnII_expression_PCR_Primer_2        	AATGATACGGCGACCACCGACAGGTTCAGAGTTC
Illumina_DpnII_expression_Sequencing_Primer   	CGACAGGTTCAGAGTTCTACAGTCCGACGATC
Illumina_NlaIII_expression_Adapter_1          	ACAGGTTCAGAGTTCTACAGTCCGACATG
Illumina_NlaIII_expression_Adapter_2          	CAAGCAGAAGACGGCATACGA
Illumina_NlaIII_expression_PCR_Primer_1       	CAAGCAGAAGACGGCATACGA
Illumina_NlaIII_expression_PCR_Primer_2       	AATGATACGGCGACCACCGACAGGTTCAGAGTTC
Illumina_NlaIII_expression_Sequencing_Primer  	CCGACAGGTTCAGAGTTCTACAGTCCGACATG
Illumina_Small_RNA_Adapter_1                  	GTTCAGAGTTCTACAGTCCGACGATC
Illumina_Small_RNA_Adapter_2                  	TCGTATGCCGTCTTCTGCTTGT
Illumina_Small_RNA_RT_Primer                  	CAAGCAGAAGACGGCATACGA
Illumina_Small_RNA_PCR_Primer_1               	CAAGCAGAAGACGGCATACGA
Illumina_Small_RNA_PCR_Primer_2               	AATGATACGGCGACCACCGACAGGTTCAGAGTTC
Illumina_Small_RNA_Sequencing_Primer          	CGACAGGTTCAGAGTTCTACAGTCCGACGATC
Illumina_Multiplexing_Adapter_1               	GATCGGAAGAGCACACGTCT
Illumina_Multiplexing_Adapter_2               	ACACTCTTTCCCTACACGACGCTCTTCCGATCT
Illumina_Multiplexing_PCR_Primer_1.01         	AATGATACGGCGACCACCGAGATCTACACTCTTT
Illumina_Multiplexing_PCR_Primer_2.01         	GTGACTGGAGTTCAGACGTGTGCTCTTCCGATC
Illumina_Multiplexing_Read1_Sequencing_Primer 	ACACTCTTTCCCTACACGACGCTCTTCCGATCT
Illumina_Multiplexing_Index_Sequencing_Primer 	GATCGGAAGAGCACACGTCTGAACTCCAGTCAC
Illumina_Multiplexing_Read2_Sequencing_Primer 	GTGACTGGAGTTCAGACGTGTGCTCTTCCGATC
Illumina_PCR_Primer_Index_1                   	CAAGCAGAAGACGGCATACGAGATCGTGATGTGA
Illumina_PCR_Primer_Index_2                   	CAAGCAGAAGACGGCATACGAGATACATCGGTGA
Illumina_PCR_Primer_Index_3                   	CAAGCAGAAGACGGCATACGAGATGCCTAAGTGA
Illumina_PCR_Primer_Index_4                   	CAAGCAGAAGACGGCATACGAGATTGGTCAGTGA
Illumina_PCR_Primer_Index_5                   	CAAGCAGAAGACGGCATACGAGATCACTGTGTGA
Illumina_PCR_Primer_Index_6                   	CAAGCAGAAGACGGCATACGAGATATTGGCGTGA
Illumina_PCR_Primer_Index_7                   	CAAGCAGAAGACGGCATACGAGATGATCTGGTGA
Illumina_PCR_Primer_Index_8                   	CAAGCAGAAGACGGCATACGAGATTCAAGTGTGA
Illumina_PCR_Primer_Index_9                   	CAAGCAGAAGACGGCATACGAGATCTGATCGTGA
Illumina_PCR_Primer_Index_10                  	CAAGCAGAAGACGGCATACGAGATAAGCTAGTGA
Illumina_PCR_Primer_Index_11                  	CAAGCAGAAGACGGCATACGAGATGTAGCCGTGA
Illumina_PCR_Primer_Index_12                  	CAAGCAGAAGACGGCATACGAGATTACAAGGTGA
Illumina_DpnII_Gex_Adapter_1                  	GATCGTCGGACTGTAGAACTCTGAAC
Illumina_DpnII_Gex_Adapter_1.01               	ACAGGTTCAGAGTTCTACAGTCCGAC
Illumina_DpnII_Gex_Adapter_2                  	CAAGCAGAAGACGGCATACGA
Illumina_DpnII_Gex_Adapter_2.01               	TCGTATGCCGTCTTCTGCTTG
Illumina_DpnII_Gex_PCR_Primer_1               	CAAGCAGAAGACGGCATACGA
Illumina_DpnII_Gex_PCR_Primer_2               	AATGATACGGCGACCACCGACAGGTTCAGAGTTC
Illumina_DpnII_Gex_Sequencing_Primer          	CGACAGGTTCAGAGTTCTACAGTCCGACGATC
Illumina_NlaIII_Gex_Adapter_1.01              	TCGGACTGTAGAACTCTGAAC
Illumina_NlaIII_Gex_Adapter_1.02              	ACAGGTTCAGAGTTCTACAGTCCGACATG
Illumina_NlaIII_Gex_Adapter_2.01              	CAAGCAGAAGACGGCATACGA
Illumina_NlaIII_Gex_Adapter_2.02              	TCGTATGCCGTCTTCTGCTTG
Illumina_NlaIII_Gex_PCR_Primer_1              	CAAGCAGAAGACGGCATACGA
Illumina_NlaIII_Gex_PCR_Primer_2              	AATGATACGGCGACCACCGACAGGTTCAGAGTTC
Illumina_NlaIII_Gex_Sequencing_Primer         	CCGACAGGTTCAGAGTTCTACAGTCCGACATG
Illumina_5p_RNA_Adapter                       	GTTCAGAGTTCTACAGTCCGACGATC
Illumina_RNA_Adapter1                         	TCGTATGCCGTCTTCTGCTTGT
Illumina_Small_RNA_3p_Adapter_1               	ATCTCGTATGCCGTCTTCTGCTTG
TruSeq_Universal_Adapter                      	AATGATACGGCGACCACCGAGATCTACACTCTTT
TruSeq_Adapter_Index_1                        	GATCGGAAGAGCACACGTCTGAACTCCAGTCACA
TruSeq_Adapter_Index_2                        	GATCGGAAGAGCACACGTCTGAACTCCAGTCACC
TruSeq_Adapter_Index_3                        	GATCGGAAGAGCACACGTCTGAACTCCAGTCACT
TruSeq_Adapter_Index_4                        	GATCGGAAGAGCACACGTCTGAACTCCAGTCACT
TruSeq_Adapter_Index_5                        	GATCGGAAGAGCACACGTCTGAACTCCAGTCACA
TruSeq_Adapter_Index_6                        	GATCGGAAGAGCACACGTCTGAACTCCAGTCACG
TruSeq_Adapter_Index_7                        	GATCGGAAGAGCACACGTCTGAACTCCAGTCACC
TruSeq_Adapter_Index_8                        	GATCGGAAGAGCACACGTCTGAACTCCAGTCACA
TruSeq_Adapter_Index_9                        	GATCGGAAGAGCACACGTCTGAACTCCAGTCACG
TruSeq_Adapter_Index_10                       	GATCGGAAGAGCACACGTCTGAACTCCAGTCACT
TruSeq_Adapter_Index_11                       	GATCGGAAGAGCACACGTCTGAACTCCAGTCACG
TruSeq_Adapter_Index_12                       	GATCGGAAGAGCACACGTCTGAACTCCAGTCACC
TruSeq_Adapter_Index_13                       	GATCGGAAGAGCACACGTCTGAACTCCAGTCACA
TruSeq_Adapter_Index_14                       	GATCGGAAGAGCACACGTCTGAACTCCAGTCACA
TruSeq_Adapter_Index_15                       	GATCGGAAGAGCACACGTCTGAACTCCAGTCACA
TruSeq_Adapter_Index_16                       	GATCGGAAGAGCACACGTCTGAACTCCAGTCACC
TruSeq_Adapter_Index_18                       	GATCGGAAGAGCACACGTCTGAACTCCAGTCACG
TruSeq_Adapter_Index_19                       	GATCGGAAGAGCACACGTCTGAACTCCAGTCACG
TruSeq_Adapter_Index_20                       	GATCGGAAGAGCACACGTCTGAACTCCAGTCACG
TruSeq_Adapter_Index_21                       	GATCGGAAGAGCACACGTCTGAACTCCAGTCACG
TruSeq_Adapter_Index_22                       	GATCGGAAGAGCACACGTCTGAACTCCAGTCACC
TruSeq_Adapter_Index_23                       	GATCGGAAGAGCACACGTCTGAACTCCAGTCACC
TruSeq_Adapter_Index_25                       	GATCGGAAGAGCACACGTCTGAACTCCAGTCACA
TruSeq_Adapter_Index_27                       	GATCGGAAGAGCACACGTCTGAACTCCAGTCACA
Illumina_RNA_RT_Primer                        	GCCTTGGCACCCGAGAATTCCA
Illumina_RNA_PCR_Primer                       	AATGATACGGCGACCACCGAGATCTACACGTTCA
RNA_PCR_Primer_Index_1                        	CAAGCAGAAGACGGCATACGAGATCGTGATGTGA
RNA_PCR_Primer_Index_2                        	CAAGCAGAAGACGGCATACGAGATACATCGGTGA
RNA_PCR_Primer_Index_3                        	CAAGCAGAAGACGGCATACGAGATGCCTAAGTGA
RNA_PCR_Primer_Index_4                        	CAAGCAGAAGACGGCATACGAGATTGGTCAGTGA
RNA_PCR_Primer_Index_5                        	CAAGCAGAAGACGGCATACGAGATCACTGTGTGA
RNA_PCR_Primer_Index_6                        	CAAGCAGAAGACGGCATACGAGATATTGGCGTGA
RNA_PCR_Primer_Index_7                        	CAAGCAGAAGACGGCATACGAGATGATCTGGTGA
RNA_PCR_Primer_Index_8                        	CAAGCAGAAGACGGCATACGAGATTCAAGTGTGA
RNA_PCR_Primer_Index_9                        	CAAGCAGAAGACGGCATACGAGATCTGATCGTGA
RNA_PCR_Primer_Index_10                       	CAAGCAGAAGACGGCATACGAGATAAGCTAGTGA
RNA_PCR_Primer_Index_11                       	CAAGCAGAAGACGGCATACGAGATGTAGCCGTGA
RNA_PCR_Primer_Index_12                       	CAAGCAGAAGACGGCATACGAGATTACAAGGTGA
RNA_PCR_Primer_Index_13                       	CAAGCAGAAGACGGCATACGAGATTTGACTGTGA
RNA_PCR_Primer_Index_14                       	CAAGCAGAAGACGGCATACGAGATGGAACTGTGA
RNA_PCR_Primer_Index_15                       	CAAGCAGAAGACGGCATACGAGATTGACATGTGA
RNA_PCR_Primer_Index_16                       	CAAGCAGAAGACGGCATACGAGATGGACGGGTGA
RNA_PCR_Primer_Index_17                       	CAAGCAGAAGACGGCATACGAGATCTCTACGTGA
RNA_PCR_Primer_Index_18                       	CAAGCAGAAGACGGCATACGAGATGCGGACGTGA
RNA_PCR_Primer_Index_19                       	CAAGCAGAAGACGGCATACGAGATTTTCACGTGA
RNA_PCR_Primer_Index_20                       	CAAGCAGAAGACGGCATACGAGATGGCCACGTGA
RNA_PCR_Primer_Index_21                       	CAAGCAGAAGACGGCATACGAGATCGAAACGTGA
RNA_PCR_Primer_Index_22                       	CAAGCAGAAGACGGCATACGAGATCGTACGGTGA
RNA_PCR_Primer_Index_23                       	CAAGCAGAAGACGGCATACGAGATCCACTCGTGA
RNA_PCR_Primer_Index_24                       	CAAGCAGAAGACGGCATACGAGATGCTACCGTGA
RNA_PCR_Primer_Index_25                       	CAAGCAGAAGACGGCATACGAGATATCAGTGTGA
RNA_PCR_Primer_Index_26                       	CAAGCAGAAGACGGCATACGAGATGCTCATGTGA
RNA_PCR_Primer_Index_27                       	CAAGCAGAAGACGGCATACGAGATAGGAATGTGA
RNA_PCR_Primer_Index_28                       	CAAGCAGAAGACGGCATACGAGATCTTTTGGTGA
RNA_PCR_Primer_Index_29                       	CAAGCAGAAGACGGCATACGAGATTAGTTGGTGA
RNA_PCR_Primer_Index_30                       	CAAGCAGAAGACGGCATACGAGATCCGGTGGTGA
RNA_PCR_Primer_Index_31                       	CAAGCAGAAGACGGCATACGAGATATCGTGGTGA
RNA_PCR_Primer_Index_32                       	CAAGCAGAAGACGGCATACGAGATTGAGTGGTGA
RNA_PCR_Primer_Index_33                       	CAAGCAGAAGACGGCATACGAGATCGCCTGGTGA
RNA_PCR_Primer_Index_34                       	CAAGCAGAAGACGGCATACGAGATGCCATGGTGA
RNA_PCR_Primer_Index_35                       	CAAGCAGAAGACGGCATACGAGATAAAATGGTGA
RNA_PCR_Primer_Index_36                       	CAAGCAGAAGACGGCATACGAGATTGTTGGGTGA
RNA_PCR_Primer_Index_37                       	CAAGCAGAAGACGGCATACGAGATATTCCGGTGA
RNA_PCR_Primer_Index_38                       	CAAGCAGAAGACGGCATACGAGATAGCTAGGTGA
RNA_PCR_Primer_Index_39                       	CAAGCAGAAGACGGCATACGAGATGTATAGGTGA
RNA_PCR_Primer_Index_40                       	CAAGCAGAAGACGGCATACGAGATTCTGAGGTGA
RNA_PCR_Primer_Index_41                       	CAAGCAGAAGACGGCATACGAGATGTCGTCGTGA
RNA_PCR_Primer_Index_42                       	CAAGCAGAAGACGGCATACGAGATCGATTAGTGA
RNA_PCR_Primer_Index_43                       	CAAGCAGAAGACGGCATACGAGATGCTGTAGTGA
RNA_PCR_Primer_Index_44                       	CAAGCAGAAGACGGCATACGAGATATTATAGTGA
RNA_PCR_Primer_Index_45                       	CAAGCAGAAGACGGCATACGAGATGAATGAGTGA
RNA_PCR_Primer_Index_46                       	CAAGCAGAAGACGGCATACGAGATTCGGGAGTGA
RNA_PCR_Primer_Index_47                       	CAAGCAGAAGACGGCATACGAGATCTTCGAGTGA
RNA_PCR_Primer_Index_48                       	CAAGCAGAAGACGGCATACGAGATTGCCGAGTGA
ABI_Dynabead_EcoP_Oligo                       	CTGATCTAGAGGTACCGGATCCCAGCAGT
ABI_Solid3_Adapter_A                          	CTGCCCCGGGTTCCTCATTCTCTCAGCAGCATG
ABI_Solid3_Adapter_B                          	CCACTACGCCTCCGCTTTCCTCTCTATGGGCAGT
ABI_Solid3_5'_AMP_Primer                      	CCACTACGCCTCCGCTTTCCTCTCTATG
ABI_Solid3_3'_AMP_Primer                      	CTGCCCCGGGTTCCTCATTCT
ABI_Solid3_EF1_alpha_Sense_Primer             	CATGTGTGTTGAGAGCTTC
ABI_Solid3_EF1_alpha_Antisense_Primer         	GAAAACCAAAGTGGTCCAC
ABI_Solid3_GAPDH_Forward_Primer               	TTAGCACCCCTGGCCAAGG
ABI_Solid3_GAPDH_Reverse_Primer               	CTTACTCCTTGGAGGCCATG

